不 用笔 不 用电 ， 无尘 无墨 好 写 光能 小黑板 电子 液晶 手写板	不 用笔 不 用电 环保 健康 低耗 无污染 不脏手 好 写 光能 小黑板	5.0
不 用笔 不 用电 环保 健康 低耗 无污染 不脏手 好 写 光能 小黑板	华 元 木制 两用 动物 计算 黑板 玩具 加工 logo 定做	5.0
华 元 木制 两用 动物 计算 黑板 玩具 加工 logo 定做	木制 二合一 画板   儿童 手写板 写字板   儿童 支架 黑板	5.0
木制 二合一 画板   儿童 手写板 写字板   儿童 支架 黑板	儿童 磁性 写字板   儿童 手写板   木制 画板   儿童 支架 黑板	5.0
儿童 磁性 写字板   儿童 手写板   木制 画板   儿童 支架 黑板	拼拼 乐 双面 儿童 学习 磁性 画板 画架   多功能 宝宝 拼图 写字 黑板	5.0
拼拼 乐 双面 儿童 学习 磁性 画板 画架   多功能 宝宝 拼图 写字 黑板	好 写 4.4 寸 不 用笔 不 用电 环保 健康 低耗 无污染 不脏 手光能 小黑板	5.0
好 写 4.4 寸 不 用笔 不 用电 环保 健康 低耗 无污染 不脏 手光能 小黑板	不 用笔 ， 不 用电 ， 无尘 无墨 ， 57 寸 好 写 光能 黑板	5.0
不 用笔 ， 不 用电 ， 无尘 无墨 ， 57 寸 好 写 光能 黑板	好 写 田字格 光能 黑板 无尘 无墨 不 用笔 不 用电 电子 小黑板	5.0
好 写 田字格 光能 黑板 无尘 无墨 不 用笔 不 用电 电子 小黑板	幼儿园 小学教师 必备 教具 黑板 磁性 贴 动物 数字 加减 创意 教学 磁贴	5.0
幼儿园 小学教师 必备 教具 黑板 磁性 贴 动物 数字 加减 创意 教学 磁贴	不 用笔 不 用电 ， 无尘 无墨 好 写 光能 小黑板 电子 液晶 手写板	5.0
电脑 鼠标垫	礼品 鼠标垫	5.0
礼品 鼠标垫	广告 鼠标垫	5.0
广告 鼠标垫	鼠标垫	5.0
鼠标垫	Q版 牛仔 鼠标垫	5.0
Q版 牛仔 鼠标垫	供应 广告 鼠标垫 、 PVC 鼠标垫 、 广告 促销品 、 个性 鼠标垫 、 橡胶 鼠标垫 、 EVA 鼠标垫 、 网吧 鼠标垫	5.0
供应 广告 鼠标垫 、 PVC 鼠标垫 、 广告 促销品 、 个性 鼠标垫 、 橡胶 鼠标垫 、 EVA 鼠标垫 、 网吧 鼠标垫	东莞 琛 华 SBD376 鼠标垫 ， 热转印 ， 促销 礼品	5.0
东莞 琛 华 SBD376 鼠标垫 ， 热转印 ， 促销 礼品	鼠标垫 ， PVC 鼠标垫 ， 入油 鼠标垫 ， 硅胶 鼠标垫 ， EVA 鼠标垫	5.0
鼠标垫 ， PVC 鼠标垫 ， 入油 鼠标垫 ， 硅胶 鼠标垫 ， EVA 鼠标垫	护腕 鼠标垫	5.0
护腕 鼠标垫	USB 鼠标垫 音响	5.0
USB 鼠标垫 音响	电脑 鼠标垫	5.0
内 画 鼻烟壶	高档 内 画 水晶球 、 内 画 鼻烟壶 - - - 礼品 赠品 收藏品	5.0
高档 内 画 水晶球 、 内 画 鼻烟壶 - - - 礼品 赠品 收藏品	内 画 鼻烟壶	5.0
万能 工匠 齿轮 吊架 系列 拼装 玩具	电瓶 碰碰车 采用 三级 齿轮 传动 省 电 耐用 运行 速度 快	5.0
电瓶 碰碰车 采用 三级 齿轮 传动 省 电 耐用 运行 速度 快	厂家 货源 售货机 齿轮 常用 型 耐磨损 工作 寿命长 贩卖机 齿轮箱	5.0
厂家 货源 售货机 齿轮 常用 型 耐磨损 工作 寿命长 贩卖机 齿轮箱	注射 成形 齿轮	5.0
注射 成形 齿轮	供应 遥控 直升飞机 系列 配件 主桨 齿轮	5.0
供应 遥控 直升飞机 系列 配件 主桨 齿轮	三阶 齿轮 魔方	5.0
三阶 齿轮 魔方	二阶 齿轮 魔方	5.0
二阶 齿轮 魔方	金字塔 齿轮 魔方	5.0
金字塔 齿轮 魔方	齿轮 魔方	5.0
齿轮 魔方	齿轮 2	5.0
齿轮 2	万能 工匠 齿轮 吊架 系列 拼装 玩具	5.0
百变 电动 音乐 积木   齿轮 积木	幼儿园 儿童 益智 拼 插 齿轮 积木   科教 创意 百变 积木	5.0
幼儿园 儿童 益智 拼 插 齿轮 积木   科教 创意 百变 积木	华隆 圆形 齿轮 积木   益智 玩具   开发智力 玩具   拼装 积木	5.0
华隆 圆形 齿轮 积木   益智 玩具   开发智力 玩具   拼装 积木	百变 电动 音乐 积木   齿轮 积木	5.0
厂家 货源 售货机 齿轮 常用 型 耐磨损 工作 寿命长 贩卖机 齿轮箱	齿轮   齿轮箱   蜗轮 蜗杆   舵机   玩具 配件   非 标准件	5.0
齿轮   齿轮箱   蜗轮 蜗杆   舵机   玩具 配件   非 标准件	减速 齿轮箱 、 玩具 减速 齿轮箱 、 玩具 塑胶 齿轮箱 、 玩具 塑料 齿轮箱	5.0
减速 齿轮箱 、 玩具 减速 齿轮箱 、 玩具 塑胶 齿轮箱 、 玩具 塑料 齿轮箱	减速 齿轮箱 / 塑料 齿轮箱 / 玩具 齿轮箱 / 电动 齿轮箱	5.0
减速 齿轮箱 / 塑料 齿轮箱 / 玩具 齿轮箱 / 电动 齿轮箱	齿轮箱 车轮 · 寻迹 智能 小车 学生 版 | 东莞 顺捷 供应商	5.0
齿轮箱 车轮 · 寻迹 智能 小车 学生 版 | 东莞 顺捷 供应商	减速 齿轮箱 设计 - 减速 齿轮箱 规格 - 减速 齿轮箱 价格	5.0
减速 齿轮箱 设计 - 减速 齿轮箱 规格 - 减速 齿轮箱 价格	顺捷 生产商 供应 【 塑胶 单轴 、 减速比 1 : 48 、 3V 】 塑胶 齿轮箱	5.0
顺捷 生产商 供应 【 塑胶 单轴 、 减速比 1 : 48 、 3V 】 塑胶 齿轮箱	【 减速器 - 塑胶 齿轮箱 - 牙箱 - 车床 件 加工 】 - 齿轮箱 生产厂家	5.0
【 减速器 - 塑胶 齿轮箱 - 牙箱 - 车床 件 加工 】 - 齿轮箱 生产厂家	供应 常用 型 售货机 单头 出柜 电机 齿轮箱   噪音 小   耗电 低	5.0
供应 常用 型 售货机 单头 出柜 电机 齿轮箱   噪音 小   耗电 低	自动售货机 齿轮箱   售货机 部件   配件	5.0
自动售货机 齿轮箱   售货机 部件   配件	厂家 货源 售货机 齿轮 常用 型 耐磨损 工作 寿命长 贩卖机 齿轮箱	5.0
充气 趣味 龙舟     端午节 趣味 运动会 道具	diy 拼图 手工 活动 爆款   YD403 龙船 龙舟   3D 立体 拼图 赠品 批发   可 开票	5.0
diy 拼图 手工 活动 爆款   YD403 龙船 龙舟   3D 立体 拼图 赠品 批发   可 开票	端午节 龙舟赛 火爆 节日 3D 立体 拼图 批发   红木 竹子 木制 仿真 模型 批发	5.0
端午节 龙舟赛 火爆 节日 3D 立体 拼图 批发   红木 竹子 木制 仿真 模型 批发	山东 青岛 新款 员工 趣味 运动会 项目 旱地 龙舟 毛毛虫 竞速 器材	5.0
山东 青岛 新款 员工 趣味 运动会 项目 旱地 龙舟 毛毛虫 竞速 器材	职工 趣味 活动 项目 大全   内蒙古 学校 趣味 运动会 器材 用品 旱地 龙舟	5.0
职工 趣味 活动 项目 大全   内蒙古 学校 趣味 运动会 器材 用品 旱地 龙舟	郑州 大风车 供应 趣味 旱地 龙舟 / 趣味 运动会 器材	5.0
郑州 大风车 供应 趣味 旱地 龙舟 / 趣味 运动会 器材	端午节 充气 赛龙舟 道具   旱地 龙舟 充气 龙舟   6 人 陆地 龙舟 比赛	5.0
端午节 充气 赛龙舟 道具   旱地 龙舟 充气 龙舟   6 人 陆地 龙舟 比赛	新款 旱地 龙舟 趣味 运动会 比赛规则   多人 陆地 龙舟 体育器材	5.0
新款 旱地 龙舟 趣味 运动会 比赛规则   多人 陆地 龙舟 体育器材	趣味 运动会 器材 陆地 龙舟 项目 比赛   旱地 龙舟 款式 新 质量 好	5.0
趣味 运动会 器材 陆地 龙舟 项目 比赛   旱地 龙舟 款式 新 质量 好	河北 保定 陆地 龙舟 趣味 运动会 器材   多人 旱地 龙舟 充气 玩具	5.0
河北 保定 陆地 龙舟 趣味 运动会 器材   多人 旱地 龙舟 充气 玩具	充气 趣味 龙舟     端午节 趣味 运动会 道具	5.0
儿童 鲤鱼 跳龙门	鲤鱼 跳龙门 多少 钱	5.0
鲤鱼 跳龙门 多少 钱	鲤鱼 跳龙门 价格	5.0
鲤鱼 跳龙门 价格	鲤鱼 跳龙门 厂家	5.0
鲤鱼 跳龙门 厂家	鲤鱼 跳龙门	5.0
鲤鱼 跳龙门	鲤鱼 跳龙门 游乐 设备 鲤鱼 跳龙门 价格 鲤鱼 跳龙门 厂家	5.0
鲤鱼 跳龙门 游乐 设备 鲤鱼 跳龙门 价格 鲤鱼 跳龙门 厂家	小型 游乐 设备 儿童 鲤鱼 跳龙门 ， 鲤鱼 跳龙门 顺航 供应商	5.0
小型 游乐 设备 儿童 鲤鱼 跳龙门 ， 鲤鱼 跳龙门 顺航 供应商	南博万 儿童 游乐 设施   厂家直销   鲤鱼 跳龙门   公园 广场 庙会 游乐	5.0
南博万 儿童 游乐 设施   厂家直销   鲤鱼 跳龙门   公园 广场 庙会 游乐	厂家直销   鲤鱼 跳龙门   公园 广场 庙会 游乐   新型 游乐 设备 价格 南博万	5.0
厂家直销   鲤鱼 跳龙门   公园 广场 庙会 游乐   新型 游乐 设备 价格 南博万	厂家 供应 鲤鱼 跳龙门     大型 游乐 设施	5.0
厂家 供应 鲤鱼 跳龙门     大型 游乐 设施	儿童 鲤鱼 跳龙门	5.0
发光 T恤	环保 USB 数据线	1.0
供应 压缩 T恤	USB 数据线	1.0
Teddy   Bear 泰迪熊   T恤 熊 收藏版	七巧板 & 棋盘	1.0
广告衫 文化衫 热转印 T恤 工作服 运动服 烫 画 T恤   烫画纸	磁性 数字 写字板 / 配 七巧板	1.0
爱心 猫 情侣 T恤	供应 七巧板 ( 图 )	1.0
北京 T恤 厂家	磁性 玩具 EN71 检测 ， 七巧板 EN71 检测	1.0
供应 发光 T恤	【 中国 木制 玩具 第一 品牌 】 木玩 世家 益智 环保     七巧板	1.0
纯真 毛绒 泰迪熊 着 时尚 T恤	婴儿 早教 益智 拼图 数字 游戏 中 号 字母 / 数字 七巧板	1.0
供应 热转印 设备 , T恤 纸 , 水晶 耗材 ( 图 )	彩色 七巧板 , 木制 玩具 , 教具 , 智力 玩具 , 儿童玩具 , 益智 玩具	1.0
供应 热转印 设备 , T恤 纸 , 米 上 刻字 ( 图 )	【 山川 】 儿童 桌面 益智 玩具   七巧板 塑料 拼图 插板 批发 2618	1.0
环保 USB 数据线	《 厂家 直供 》   精品 七巧板 之谜 - - 成人 益智 玩具   丹妮 奇特	1.0
USB 数据线	【 大圣 玩具 】 # 七巧板	1.0
七巧板 & 棋盘	厂家直销   万圣节 舞会 化妆 派对 玩具 闪光 音乐 鬼头 蝙蝠 南瓜 剑 荧光棒	1.0
磁性 数字 写字板 / 配 七巧板	厂家直销   万圣节 舞会 化妆 派对 玩具 场景 布置 道具 闪光 音乐 蝙蝠 灯	1.0
供应 七巧板 ( 图 )	厂家直销 万圣节 舞会 化妆 派对 玩具 场地 布置 道具 闪光 音乐 搞怪 南瓜 灯	1.0
磁性 玩具 EN71 检测 ， 七巧板 EN71 检测	厂家直销 万圣节 舞会 化妆 派对 玩具 闪光 音乐 搞怪 蝙蝠 南瓜 鬼头 荧光棒	1.0
【 中国 木制 玩具 第一 品牌 】 木玩 世家 益智 环保     七巧板	厂家直销 万圣节 舞会 化妆 派对 玩具 闪光 音乐 搞怪 鬼头 南瓜 巫婆 荧光棒	1.0
婴儿 早教 益智 拼图 数字 游戏 中 号 字母 / 数字 七巧板	厂家直销   万圣节 舞会 化妆 派对 玩具 闪光 音乐 搞怪 鬼头 南瓜 巫婆 神灯	1.0
彩色 七巧板 , 木制 玩具 , 教具 , 智力 玩具 , 儿童玩具 , 益智 玩具	厂家直销   万圣节 舞会 化妆 派对 玩具 闪光 音乐 巫婆 南瓜 鬼 叫 门铃	1.0
【 山川 】 儿童 桌面 益智 玩具   七巧板 塑料 拼图 插板 批发 2618	厂家直销   万圣节 舞会 化妆 派对 玩具 场景 布置 道具 闪光 音乐 骷髅头	1.0
《 厂家 直供 》   精品 七巧板 之谜 - - 成人 益智 玩具   丹妮 奇特	厂家直销   万圣节 舞会 化妆 派对 玩具 场地 布置 恶搞 道具 植绒 夜光 蜘蛛	1.0
【 大圣 玩具 】 # 七巧板	厂家直销 万圣节 舞会 化妆 派对 玩具 闪光 音乐 搞怪 蝙蝠 鬼头 南瓜 荧光棒	1.0
厂家直销   万圣节 舞会 化妆 派对 玩具 闪光 音乐 鬼头 蝙蝠 南瓜 剑 荧光棒	供应 万圣节 面具 ( 图 )	1.0
厂家直销   万圣节 舞会 化妆 派对 玩具 场景 布置 道具 闪光 音乐 蝙蝠 灯	圣诞节 灯饰 、 LED 节日 彩灯 、 万圣节 面具 儿童 面具	1.0
厂家直销 万圣节 舞会 化妆 派对 玩具 场地 布置 道具 闪光 音乐 搞怪 南瓜 灯	万圣节 面具 定做   纸浆 面具   半脸 面具   羽毛 面具	1.0
厂家直销 万圣节 舞会 化妆 派对 玩具 闪光 音乐 搞怪 蝙蝠 南瓜 鬼头 荧光棒	深圳   万圣节 面具   厂家直销   发光 面具   毛毡 面具	1.0
厂家直销 万圣节 舞会 化妆 派对 玩具 闪光 音乐 搞怪 鬼头 南瓜 巫婆 荧光棒	面具 定做 厂家 批发 万圣节 面具 ， 化妆舞会 面具	1.0
厂家直销   万圣节 舞会 化妆 派对 玩具 闪光 音乐 搞怪 鬼头 南瓜 巫婆 神灯	万圣节 面具 手绘 化妆舞会 面具 环保 威尼斯 面具	1.0
厂家直销   万圣节 舞会 化妆 派对 玩具 闪光 音乐 巫婆 南瓜 鬼 叫 门铃	eva 南瓜 鬼脸 面具   南瓜 礼品   面具 厂家   万圣节 面具 批发	1.0
厂家直销   万圣节 舞会 化妆 派对 玩具 场景 布置 道具 闪光 音乐 骷髅头	eva 半脸 面具   万圣节 面具   圣诞节 儿童 面具	1.0
厂家直销   万圣节 舞会 化妆 派对 玩具 场地 布置 恶搞 道具 植绒 夜光 蜘蛛	万圣节 面具   鬼节 面具   万圣节 面具 批发	1.0
厂家直销 万圣节 舞会 化妆 派对 玩具 闪光 音乐 搞怪 蝙蝠 鬼头 南瓜 荧光棒	厂家直销 pvc 万圣节 面具   儿童 面具   小狼 面具	1.0
供应 万圣节 面具 ( 图 )	安庆 充气 城堡       万森 充气 城堡 厂家 定制	1.0
